TILEMAP
36 28 							-- Size of tile map in tiles
16 32 							-- Tile size & block size
images/scene2.png 	-- Tilesheet
4 2 								-- Number of tiles in tilesheet
343434343434343434343434343434343434
434343434343434343434343434343434343
343434343434343434343434343434343434
443434343434343434343434343434343433
434343434343434343434343434343434344
343434343434343434343434343434343433
434343434343434343434343434343434344
343434343434343434343434343434343443
443434343434343434343434343434343434
343434343434343434343434343434343433
434343434343434343434343434343434344
343434343434343434343466666666666666
4434343434343434343435              
3443434343434343434345              
4366664666636666666666              
35    6    6                        
45                                  
35                 a     9          
45                 21212121212128221
35 a    c          66666666666668666
4312121212821                   8   
6666666666866                   8   
          8                     8   
          8                     8   
          8                     8   
                                    
121212121212121212121212112121212121
343434343434343434343434343434343434