TILEMAP
36 28 							-- Size of tile map in tiles
16 32 							-- Tile size & block size
images/scene2.png 	-- Tilesheet
4 2								-- Number of tiles in tilesheet
343434343434343434343434343434343434
434343434343434343434343434343434343
343434343434343434343434343434343434
443434343434343434343434343434343433
434343434343434343434343434343434344
343434343434343434343434343434343433
434343434343434343434343434343434344
343434343434343434343434343434343443
443434343434343434343434343434343434
343434343434343434343434343434343433
434343434343434343434343434343434344
666666666666666666666666663434343433
                          7434343444
                          7343434343
                          7434343434
                          7343434343
                          7434343433
              p           6666666643
212121      12821212181   g       73
666666      66866666686           73
              8      8            73
              8      8         y  74
              8      8       1218133
              8      8       6668644
              8      8          8 73
                                  74
121212121212121212121212112121212143
343434343434343434343434343434343434


