TILEMAP
36 28 							-- Size of tile map in tiles
16 32 							-- Tile size & block size
images/scene2.png 	-- Tilesheet
4 2 								-- Number of tiles in tilesheet
343434343434343434343434343434343434
434343434343434343434343434343434343
343434343434343434343434343434343434
436666666666666666636666666666666666
35                 6                
35                                  
35           b                      
35          121282121212121212121212
            666686666666666666663666
                8               6   
                8                   
                8                   
          a                         
121212121212121212121212121212121212
346666666666666666666666666666666634
358888888888888888888888888888888873
358888888888888888888888888888888873
358888888888888888888888888888888873
358888888888888888888888888888888873
331212121212121212121212121212121233
332121212121212121212121212121212133
331212121212121212121212121212121233
332121212121212121212121212121212133
343434343434343434343434343434343434
434343434343434343434343434343434343
434343434343434343434343434343434343
343434343434343434343434343434343434
434343434343434343434343434343434343