TILEMAP
36 28 							-- Size of tile map in tiles
16 32 							-- Tile size & block size
images/scene1.png 	-- Tilesheet
4 2								-- Number of tiles in tilesheet
433434343434343434343434343434343434
434343434343434343434343434343434343
343434343434343434343434343434343434
434343434343434343434343434343434343
343434343434343434343434343434343434
434343434343434343434343434343434343
343434343434343434343434343434343434
336666666666666666636666666366666666
35                 6       3        
35                         4        
35                         6        
35                                  
35                                  
35    128121212121212812      128212
35    668666666666666866      668333
35      8            8          8 73
35      8            8          8 73
35      8            8          8 73
35      8            8          8 73
35              9            a    73
331212121212121212121212121212121233
343434343434343434343434343434343434
434343434343434343434343434343434343
343434343434343434343434343434343434
434343434343434343434343434343434343
434343434343434343434343434343434343
343434343434343434343434343434343434
434343434343434343434343434343434343